BBBBBBBBBBBBBBBBBBBBBBBB
B......................B
B..B.....BBBBBB.....B..B
B.......B......B.......B
B......................B
B..........BB..........B
B......................B
B......BB......BB......B
BB....P.B..BB..B......BB
BB......B..BB..B.Q....BB
B......BB......BB......B
B......................B
B..........BB..........B
B......................B
B.......B......B.......B
B..B.....BBBBBB.....B..B
B......................B
BBBBBBBBBBBBBBBBBBBBBBBB